


      NO ./sprites/wall_west.xpm 
      



  WE       ./sprites/wall_north.xpm

      EA ./sprites/wall_east.xpm

      SO ./sprites/wall_south.xpm

         F    49, 79, 49
     C    101,133,  161


        111111111111111111111111
        10000000001100000000000011
        100110000011100000000000011
        10010000000000000000000011
111111111011000001110000000000001
100000000011000001110111110111111
1111011111111101110000001000111
1111111111111011101010010001
1100000011010111100000000001111111111
1000N000000000001100000010000000000001
10000000000000011010100100000000000001
11000001110101011111011110001111111111
11111111 1110101 101111010001
11111111 1111111 111111111111
