      NO ./textures/brick.xpm
      EA ./textures/brick.xpm
      SO ./textures/brick.xpm
  WE ./textures/brick.xpm
         F    9, 63, 125
     C 87, 130, 99

1111111111111111111111111
1000000000000000000000001
1000000011111110000000001
10000000100N0110000000001
1000000000000110000000001
1000000000000000000000001
1000000000000000000000001
1000000000000000000000001
1000000000000000000000001
1111000000000000000001111
1111000000000000000001111
1111111111111111111111111
1111111111111111111111111
1111111111111111111111111
1111111111111111111111111
1111111111111111111111111
1111111111111111111111111
1111111111111111111111111
1111111111111111111111111
1111111111111111111111111
1111111111111111111111111
