      NO ./sprites/wall1.xpm
      EA ./sprites/wall2.xpm
      SO ./sprites/wall3.xpm
  WE ./sprites/wall4.xpm
         F    9, 63, 125
     C 87, 130, 99

1111111111111111111111111
1000000000000000000000001
1000000011111110000000001
1000000010000110000000001
1000000000000110000000001
1000000000000000000000001
1000000000000000000000001
10000000000N0000000000001
1000000000000000000000001
1111000000000000000001111
1111000000000000000001111
1111000000000000000001111
111100000000000000000111
1110000000000000000011111
11111100000000000000000111
111110000000000000000011
1100000000000000000111
11100000000000000000111111
1100000000000000000111111
110000000000000000011111
1111111111111111111111111
