      NO ./sprites/wall1.xpm
      EA ./sprites/wall2.xpm
      SO ./sprites/wall3.xpm
  WE ./sprites/wall4.xpm
         C    9, 63, 125
     F 87, 130, 99,


        1111111111111111111111111
        10000000001100000000000011
        100110000011100001111000011
        100100000000000001  100011
11111111101100000111000001  10001
100000000011000001110111111111111
11110111111111011100000010001
11110111111111011101010010001
11000000110101011100000000001
10000000000000001100000010001
100000N0000000001101010010001
1100000111010101111101111000111
11111111 1110101 101111010001
11111111 1111111 111111111111
